1 1111111111
1          1
1          1
1    X     1
1          1
1          1
1          1
1          1
1          1
1          1
111111111111
